4 5
15 10

2

tileMapTown 12 11
tileMapBattle 18 11

1 1 2 1 1 1 1 1 1 3 1 1 1 2 1
151 152 153 1 1 1 1 1 1 1 1 1 1 1 1
169 170 171 3 1 1 2 1 1 1 2 1 1 1 1
187 188 189 1 1 1 1 1 1 2 1 1 1 1 1
1 1 2 1 1 1 1 1 1 1 1 1 1 1 1
1 1 1 1 1 1 1 1 1 1 3 1 1 1 1
2 1 1 1 1 1 2 1 1 1 1 2 1 1 1
1 1 2 1 1 1 1 1 1 1 1 1 1 1 1
1 1 1 1 3 1 1 1 1 1 1 1 1 1 1
2 1 1 1 2 1 1 1 1 2 1 1 1 1 1

0 0 0 0 0 0 0 0 5 0 0 0 0 0 29
0 0 0 0 0 0 0 0 17 0 0 0 0 0 0
0 0 0 0 0 0 0 0 0 0 0 0 0 0 0
0 0 0 0 0 0 0 0 0 0 0 6 0 0 0
6 0 0 0 0 0 0 0 0 0 29 0 0 0 0
0 0 0 0 0 0 6 0 0 0 0 0 0 0 0
0 0 0 0 5 0 0 0 0 0 0 0 0 0 0
29 0 0 0 17 0 0 0 6 0 0 0 0 29 0
0 0 0 0 0 0 0 0 0 0 29 0 0 0 0
29 0 0 0 0 6 0 0 0 0 0 0 0 0 0

0 0 0 0 0 0 0 0 0 0 0 0 0 0 1
1 1 1 0 0 0 0 0 1 0 0 0 0 0 0
1 1 1 0 0 0 0 0 0 0 0 0 0 0 0
1 1 1 0 0 0 0 0 0 0 0 1 0 0 0
1 0 0 0 0 0 0 0 0 0 1 0 0 0 0
0 0 0 0 0 0 1 0 0 0 0 0 0 0 0
0 0 0 0 0 0 0 0 0 0 0 0 0 0 0
1 0 0 0 1 0 0 0 1 0 0 0 0 1 0
0 0 0 0 0 0 0 0 0 0 1 0 0 0 0
1 0 0 0 0 1 0 0 0 0 0 0 0 0 0